target h 2 0 2 A
v2 v 2 2 0 B 
v2 v 2 3 1 C 
v2 v 2 2 2 D
v2 h 2 0 3 E
v2 h 2 3 3 F
v2 v 2 0 4 G
v2 v 2 1 4 H
v2 h 2 2 4 I
v2 h 2 2 5 J
v3 h 3 3 0 K
v3 v 3 5 2 L