target h 2 3 2 A
v2 h 2 0 0 B
v2 h 2 0 1 C
v2 v 2 1 2 D
v2 v 2 0 3 E
v2 h 2 1 4 F
v2 v 2 3 3 G
v2 h 2 4 3 O
v2 h 2 4 4 U
v3 v 3 2 0 J
v3 v 3 5 0 K
v3 h 3 1 5 L