target h 2 0 2 A
v2 v 2 0 0 B
v2 h 2 2 0 C
v2 v 2 4 0 D
v2 v 2 5 0 E
v2 v 2 2 2 G
v2 v 2 3 2 H
v2 v 2 4 2 I
v2 v 2 3 4 J
v2 h 2 4 4 K
v3 h 3 1 1 F
v3 h 3 0 5 P