target h 2 3 2 A
v2 h 2 1 0 B
v2 v 2 4 0 C
v2 v 2 1 1 D
v2 v 2 2 1 E
v2 v 2 3 3 F
v2 v 2 2 4 G
v2 h 2 4 4 H
v2 h 2 3 5 I
v2 h 2 0 5 J
v3 v 3 0 0 K
v3 v 3 5 1 L
v3 h 3 0 3 Z