target h 2 0 2 A
v2 v 2 0 0 B
v2 h 2 2 1 C
v2 v 2 2 2 D
v2 v 2 3 2 E
v2 h 2 0 3 F
v2 v 2 3 4 G
v2 h 2 4 4 H
v3 h 3 1 0 I
v3 v 3 4 0 J
v2 h 2 0 5 O