target h 2 1 2 A
v2 v 2 0 0 B
v2 v 2 1 0 C
v2 h 2 2 0 E
v2 h 2 2 1 F
v2 v 2 4 0 G
v2 v 2 5 0 H
v2 v 2 3 2 I
v2 v 2 5 2 J
v2 v 2 2 3 K
v2 h 2 0 5 L
v3 v 3 0 2 Q
v3 h 3 3 4 O
v3 h 3 2 5 P