target h 2 3 2 A
v2 h 2 0 0 B 
v2 v 2 5 0 C
v2 v 2 0 1 D
v2 h 2 3 1 E
v2 h 2 0 3 F
v2 h 2 0 4 G
v2 h 2 2 3 H
v2 v 2 2 4 I
v2 v 2 4 3 J
v3 h 3 2 0 K
v3 v 3 5 2 L
v3 h 3 3 5 Q
